thanh xuân	hà nội
đại lộc	quảng nam
sóc trăng	sóc trăng
pác nặm	bắc kạn
văn yên	yên bái
lạng sơn	lạng sơn
khoái châu	hưng yên
ninh bình	ninh bình
phù mỹ	bình định
lộc ninh	bình phước
quỳ châu	nghệ an
sơn dương	tuyên quang
hiệp hòa	bắc giang
bảo lạc	cao bằng
đan phượng	hà nội
buôn đôn	đắk lắk
thuận nam	ninh thuận
cẩm mỹ	đồng nai
mỏ cày nam	bến tre
nghĩa hành	quảng ngãi
quỳnh nhai	sơn la
trà cú	trà vinh
vĩnh bảo	hải phòng
tuy hòa	phú yên
kỳ sơn	hòa bình
kông chro	gia lai
thủy nguyên	hải phòng
như xuân	thanh hóa
giá rai	bạc liêu
lâm hà	lâm đồng
vinh	nghệ an
tuyên quang	tuyên quang
văn lâm	hưng yên
sông mã	sơn la
cát hải	hải phòng
cam lâm	khánh hòa
mỹ đức	hà nội
duy tiên	hà nam
đắk hà	kon tum
phú xuyên	hà nội
triệu sơn	thanh hóa
phước long	bình phước
thăng bình	quảng nam
ứng hòa	hà nội
anh sơn	nghệ an
bảo thắng	lào cai
hoàng mai	nghệ an
quận 5|5|q5	hồ chí minh
nam trà my	quảng nam
xuyên mộc	bà rịa vũng tàu
sông hinh	phú yên
vân canh	bình định
việt trì	phú thọ
giồng trôm	bến tre
trần đề	sóc trăng
tuy đức	đắk nông
an nhơn	bình định
đống đa	hà nội
tân phước	tiền giang
phú quốc	kiên giang
krông búk	đắk lắk
hồng dân	bạc liêu
hải hậu	nam định
pleiku	gia lai
vĩnh thạnh	cần thơ
hàm tân	bình thuận
phú giáo	bình dương
bến lức	long an
trảng bàng	tây ninh
nhơn trạch	đồng nai
cù lao dung	sóc trăng
lâm thao	phú thọ
bá thước	thanh hóa
ngọc hồi	kon tum
trà ôn	vĩnh long
chợ lách	bến tre
cao phong	hòa bình
châu thành	kiên giang
vị thủy	hậu giang
mộc hóa	long an
tiền hải	thái bình
thạch hà	hà tĩnh
thuận châu	sơn la
phổ yên	thái nguyên
thanh khê	đà nẵng
trạm tấu	yên bái
yên khánh	ninh bình
ngô quyền	hải phòng
diên khánh	khánh hòa
quảng điền	thừa thiên huế
thanh chương	nghệ an
can lộc	hà tĩnh
hải lăng	quảng trị
trà vinh	trà vinh
tân hưng	long an
mường nhé	điện biên
a lưới	thừa thiên huế
kbang	gia lai
kim bôi	hòa bình
hà tĩnh	hà tĩnh
tuần giáo	điện biên
đắk glei	kon tum
lương sơn	hòa bình
phú thọ	phú thọ
nam sách	hải dương
mai sơn	sơn la
diễn châu	nghệ an
đình lập	lạng sơn
quảng uyên	cao bằng
mường khương	lào cai
ngã năm	sóc trăng
phú nhuận	hồ chí minh
quảng yên	quảng ninh
bù đăng	bình phước
an dương	hải phòng
lục yên	yên bái
kon tum	kon tum
thanh trì	hà nội
nam trực	nam định
ea h'leo	đắk lắk
ba vì	hà nội
lâm bình	tuyên quang
điện bàn	quảng nam
tam điệp	ninh bình
cửa lò	nghệ an
thông nông	cao bằng
ninh hải	ninh thuận
đức huệ	long an
giao thủy	nam định
đoan hùng	phú thọ
nha trang	khánh hòa
quế sơn	quảng nam
tủa chùa	điện biên
nam định	nam định
vĩnh long	vĩnh long
hậu lộc	thanh hóa
cát tiên	lâm đồng
mai châu	hòa bình
sơn trà	đà nẵng
phú quí	bình thuận
từ liêm|nam từ liêm	hà nội
văn chấn	yên bái
sơn tây	quảng ngãi
điện biên đông	điện biên
lạc dương	lâm đồng
long hồ	vĩnh long
hữu lũng	lạng sơn
qui nhơn	bình định
hoàn kiếm	hà nội
thanh miện	hải dương
cư jút	đắk nông
quận 7|7|q7	hồ chí minh
lý sơn	quảng ngãi
long biên	hà nội
chợ mới	an giang
bảo lâm	cao bằng
tây trà	quảng ngãi
quế võ	bắc ninh
tri tôn	an giang
tháp mười	đồng tháp
bảo yên	lào cai
bắc bình	bình thuận
khánh vĩnh	khánh hòa
hòa bình	bạc liêu
sông cầu	phú yên
quận 6|6|q6	hồ chí minh
chiêm hóa	tuyên quang
sốp cộp	sơn la
châu thành	trà vinh
thiệu hóa	thanh hóa
thái hòa	nghệ an
liên chiểu	đà nẵng
lộc hà	hà tĩnh
bình đại	bến tre
hóc môn	hồ chí minh
hà giang	hà giang
tuy phước	bình định
thanh hà	hải dương
tân yên	bắc giang
bạc liêu	bạc liêu
đồng văn	hà giang
lạng giang	bắc giang
thanh ba	phú thọ
đồng xuân	phú yên
lệ thủy	quảng bình
thanh thủy	phú thọ
cao lãnh	đồng tháp
ba tri	bến tre
mường lát	thanh hóa
sìn hồ	lai châu
nghi xuân	hà tĩnh
gia nghĩa	đắk nông
dĩ an	bình dương
tân lạc	hòa bình
hương khê	hà tĩnh
bà rịa	bà rịa vũng tàu
bình thủy	cần thơ
vĩnh tường	vĩnh phúc
tân hồng	đồng tháp
quế phong	nghệ an
phú hòa	phú yên
tương dương	nghệ an
hương trà	thừa thiên huế
vạn ninh	khánh hòa
châu thành	đồng tháp
bác ái	ninh thuận
phúc thọ	hà nội
krông bông	đắk lắk
nguyên bình	cao bằng
quận 10|10|q10	hồ chí minh
u minh	cà mau
đăk đoa	gia lai
cẩm khê	phú thọ
cư kuin	đắk lắk
kiên hải	kiên giang
hoành bồ	quảng ninh
đông hải	bạc liêu
gio linh	quảng trị
thường xuân	thanh hóa
bắc kạn	bắc kạn
bắc giang	bắc giang
kiến tường	long an
an minh	kiên giang
yên thành	nghệ an
phúc yên	vĩnh phúc
đà bắc	hòa bình
hạ lang	cao bằng
vĩnh linh	quảng trị
bát xát	lào cai
hòa vang	đà nẵng
đạ huoai	lâm đồng
ba chẽ	quảng ninh
ia h' drai	kon tum
ngũ hành sơn	đà nẵng
phước sơn	quảng nam
yên lập	phú thọ
sơn tịnh	quảng ngãi
củ chi	hồ chí minh
tiểu cần	trà vinh
đầm dơi	cà mau
hà trung	thanh hóa
hồng bàng	hải phòng
phục hòa	cao bằng
hải châu	đà nẵng
cái nước	cà mau
hoàng mai	hà nội
đồng xoài	bình phước
đồng phú	bình phước
bến tre	bến tre
đông triều	quảng ninh
phù yên	sơn la
ninh kiều	cần thơ
gò dầu	tây ninh
điện biên	điện biên
văn lãng	lạng sơn
châu thành	long an
thạch thành	thanh hóa
phù ninh	phú thọ
long xuyên	an giang
chi lăng	lạng sơn
trà bồng	quảng ngãi
yên châu	sơn la
tam đường	lai châu
việt yên	bắc giang
đất đỏ	bà rịa vũng tàu
mỏ cày bắc	bến tre
thanh liêm	hà nam
phủ lý	hà nam
quảng trị	quảng trị
yên sơn	tuyên quang
đăk glong	đắk nông
lục ngạn	bắc giang
lập thạch	vĩnh phúc
yên mô	ninh bình
hòn đất	kiên giang
cao bằng	cao bằng
yên lạc	vĩnh phúc
thái bình	thái bình
tam bình	vĩnh long
đức linh	bình thuận
châu đốc	an giang
ý yên	nam định
hoài đức	hà nội
na rì	bắc kạn
quan sơn	thanh hóa
kiến an	hải phòng
an lão	hải phòng
vị thanh	hậu giang
vĩnh thạnh	bình định
võ nhai	thái nguyên
phụng hiệp	hậu giang
bắc quang	hà giang
gia lộc	hải dương
nghĩa đàn	nghệ an
quận 3|3|q3	hồ chí minh
cai lậy	tiền giang
hà quảng	cao bằng
nho quan	ninh bình
ân thi	hưng yên
nga sơn	thanh hóa
long thành	đồng nai
càng long	trà vinh
như thanh	thanh hóa
cần đước	long an
bình thạnh	hồ chí minh
ba tơ	quảng ngãi
bình giang	hải dương
tam đảo	vĩnh phúc
minh long	quảng ngãi
đức cơ	gia lai
tân thành	bà rịa vũng tàu
sa pa	lào cai
phong điền	thừa thiên huế
tư nghĩa	quảng ngãi
sầm sơn	thanh hóa
đông hà	quảng trị
nhà bè	hồ chí minh
vĩnh hưng	long an
kiên lương	kiên giang
nghĩa lộ	yên bái
từ sơn	bắc ninh
ninh phước	ninh thuận
tân uyên	bình dương
đơn dương	lâm đồng
krông nô	đắk nông
quỳnh phụ	thái bình
tây sơn	bình định
cẩm xuyên	hà tĩnh
dầu tiếng	bình dương
chợ mới	bắc kạn
bù đốp	bình phước
phan rang-tháp chàm	ninh thuận
văn quan	lạng sơn
thoại sơn	an giang
mường la	sơn la
huế	thừa thiên huế
tam kỳ	quảng nam
chợ gạo	tiền giang
thanh oai	hà nội
ia grai	gia lai
cái bè	tiền giang
đức phổ	quảng ngãi
sóc sơn	hà nội
quảng ngãi	quảng ngãi
đông sơn	thanh hóa
bình xuyên	vĩnh phúc
ngọc lặc	thanh hóa
tuy an	phú yên
tuy phong	bình thuận
thuận an	bình dương
nông cống	thanh hóa
năm căn	cà mau
ngọc hiển	cà mau
châu thành a	hậu giang
thống nhất	đồng nai
kiến thụy	hải phòng
châu thành	sóc trăng
tứ kỳ	hải dương
đông giang	quảng nam
ayun pa	gia lai
thanh bình	đồng tháp
gia bình	bắc ninh
phong điền	cần thơ
yên bái	yên bái
cà mau	cà mau
ea súp	đắk lắk
nậm pồ	điện biên
hoàng su phì	hà giang
lai châu	lai châu
quan hóa	thanh hóa
đà lạt	lâm đồng
lạc sơn	hòa bình
ngã bảy	hậu giang
quản bạ	hà giang
buôn ma thuột	đắk lắk
chư sê	gia lai
krông pắc	đắk lắk
tam dương	vĩnh phúc
gia viễn	ninh bình
đông anh	hà nội
hà đông	hà nội
ô môn	cần thơ
biên hòa	đồng nai
phú lộc	thừa thiên huế
thới bình	cà mau
rạch giá	kiên giang
tân thạnh	long an
cầu giấy	hà nội
lý nhân	hà nam
quận 9|9|q9	hồ chí minh
mang yang	gia lai
thạnh phú	bến tre
châu phú	an giang
trùng khánh	cao bằng
gò công tây	tiền giang
cẩm giàng	hải dương
phú vang	thừa thiên huế
phú thiện	gia lai
đô lương	nghệ an
nghĩa hưng	nam định
phú bình	thái nguyên
đắk mil	đắk nông
phù cừ	hưng yên
xuân lộc	đồng nai
hải hà	quảng ninh
điện biên phủ	điện biên
quang bình	hà giang
yên minh	hà giang
sa thầy	kon tum
châu thành	hậu giang
tân biên	tây ninh
lương tài	bắc ninh
châu thành	an giang
yên mỹ	hưng yên
cẩm lệ	đà nẵng
gò công	tiền giang
ngân sơn	bắc kạn
cần giuộc	long an
mèo vạc	hà giang
đồng hỷ	thái nguyên
đa krông	quảng trị
khánh sơn	khánh hòa
bạch thông	bắc kạn
cờ đỏ	cần thơ
tánh linh	bình thuận
duyên hải	trà vinh
đức trọng	lâm đồng
hạ hòa	phú thọ
vĩnh yên	vĩnh phúc
lộc bình	lạng sơn
hương thủy	thừa thiên huế
sơn hòa	phú yên
long khánh	đồng nai
trà lĩnh	cao bằng
tràng định	lạng sơn
kim động	hưng yên
đức thọ	hà tĩnh
hàm thuận bắc	bình thuận
bảo lộc	lâm đồng
sa đéc	đồng tháp
quảng ninh	quảng bình
hiệp đức	quảng nam
trường sa	khánh hòa
cầu kè	trà vinh
thới lai	cần thơ
bố trạch	quảng bình
nam giang	quảng nam
yên định	thanh hóa
cô tô	quảng ninh
duy xuyên	quảng nam
chư păh	gia lai
mang thít	vĩnh long
bình sơn	quảng ngãi
giồng riềng	kiên giang
chí linh	hải dương
đắk tô	kon tum
tịnh biên	an giang
thủ đức	hồ chí minh
bình long	bình phước
hòa thành	tây ninh
gò quao	kiên giang
tân phú	hồ chí minh
na hang	tuyên quang
ba đình	hà nội
bỉm sơn	thanh hóa
mê linh	hà nội
hòa bình	hòa bình
đại từ	thái nguyên
phú tân	cà mau
quận 8|8|q8	hồ chí minh
tĩnh gia	thanh hóa
ba đồn	quảng bình
krông a na	đắk lắk
long điền	bà rịa vũng tàu
bắc yên	sơn la
tân kỳ	nghệ an
đắk song	đắk nông
kế sách	sóc trăng
hàm thuận nam	bình thuận
tiên lữ	hưng yên
hải dương	hải dương
mù căng chải	yên bái
kim bảng	hà nam
hưng yên	hưng yên
sông lô	vĩnh phúc
thanh hóa	thanh hóa
đông hòa	phú yên
hưng nguyên	nghệ an
tân bình	hồ chí minh
đam rông	lâm đồng
tân châu	an giang
cẩm phả	quảng ninh
gò công đông	tiền giang
yên thủy	hòa bình
nam đông	thừa thiên huế
bảo lâm	lâm đồng
mộ đức	quảng ngãi
yên phong	bắc ninh
bình minh	vĩnh long
cam lộ	quảng trị
từ liêm|bắc từ liêm	hà nội
bù gia mập	bình phước
quận 4|4|q4	hồ chí minh
tây hồ	hà nội
châu thành	tây ninh
tân phú đông	tiền giang
định hóa	thái nguyên
ia pa	gia lai
bình tân	hồ chí minh
mộc châu	sơn la
krông năng	đắk lắk
phú tân	an giang
phú lương	thái nguyên
vĩnh lộc	thanh hóa
mường ảng	điện biên
hoài nhơn	bình định
chợ đồn	bắc kạn
lai vung	đồng tháp
phong thổ	lai châu
kỳ sơn	nghệ an
tiên yên	quảng ninh
tu mơ rông	kon tum
hưng hà	thái bình
vũ thư	thái bình
tây ninh	tây ninh
đức hòa	long an
phan thiết	bình thuận
yên thế	bắc giang
quảng trạch	quảng bình
đắk r'lấp	đắk nông
giang thành	kiên giang
thọ xuân	thanh hóa
bến cát	bình dương
sơn động	bắc giang
móng cái	quảng ninh
tân phú	đồng nai
thạnh hóa	long an
thuận thành	bắc ninh
la gi	bình thuận
tam nông	đồng tháp
đông hưng	thái bình
quận 12|12|q12	hồ chí minh
an lão	bình định
lạc thủy	hòa bình
tây hòa	phú yên
đăk pơ	gia lai
tân sơn	phú thọ
thái thụy	thái bình
mỹ hào	hưng yên
vĩnh lợi	bạc liêu
trấn yên	yên bái
vị xuyên	hà giang
tân châu	tây ninh
đầm hà	quảng ninh
tân uyên	lai châu
hai bà trưng	hà nội
thuận bắc	ninh thuận
mỹ lộc	nam định
vĩnh cửu	đồng nai
định quán	đồng nai
quỳ hợp	nghệ an
châu đức	bà rịa vũng tàu
dương minh châu	tây ninh
xín mần	hà giang
cư m'gar	đắk lắk
thủ thừa	long an
uông bí	quảng ninh
thái nguyên	thái nguyên
mỹ xuyên	sóc trăng
lào cai	lào cai
châu thành	tiền giang
lắk	đắk lắk
u minh thượng	kiên giang
thạnh trị	sóc trăng
yên dũng	bắc giang
thạch an	cao bằng
đồng hới	quảng bình
cẩm thủy	thanh hóa
hòa an	cao bằng
phú riềng	bình phước
chư pưh	gia lai
thường tín	hà nội
nông sơn	quảng nam
vụ bản	nam định
tiên phước	quảng nam
hồng ngự	đồng tháp
quận 2|2|q2	hồ chí minh
thanh sơn	phú thọ
tân an	long an
mường lay	điện biên
đạ tẻh	lâm đồng
tiên lãng	hải phòng
chư prông	gia lai
yên bình	yên bái
di linh	lâm đồng
thạch thất	hà nội
lê chân	hải phòng
mường tè	lai châu
vũ quang	hà tĩnh
bắc hà	lào cai
gia lâm	hà nội
hội an	quảng nam
hồng lĩnh	hà tĩnh
vĩnh châu	sóc trăng
bắc trà my	quảng nam
quảng xương	thanh hóa
quỳnh lưu	nghệ an
hàm yên	tuyên quang
hương sơn	hà tĩnh
kinh môn	hải dương
vũng tàu	bà rịa vũng tàu
trần văn thời	cà mau
bến cầu	tây ninh
hướng hóa	quảng trị
nghi lộc	nghệ an
an khê	gia lai
krông pa	gia lai
ea kar	đắk lắk
mường chà	điện biên
bàu bàng	bình dương
sơn la	sơn la
trực ninh	nam định
vũng liêm	vĩnh long
con cuông	nghệ an
sơn tây	hà nội
kon plông	kon tum
thốt nốt	cần thơ
cao lộc	lạng sơn
cái răng	cần thơ
thủ dầu một	bình dương
than uyên	lai châu
minh hóa	quảng bình
lang chánh	thanh hóa
buôn hồ	đắk lắk
nậm nhùn	lai châu
nam đàn	nghệ an
mỹ tho	tiền giang
tân trụ	long an
bình liêu	quảng ninh
sông công	thái nguyên
hải an	hải phòng
châu thành	bến tre
ba bể	bắc kạn
ninh sơn	ninh thuận
tiên du	bắc ninh
tân hiệp	kiên giang
vân đồn	quảng ninh
lục nam	bắc giang
trảng bom	đồng nai
kim thành	hải dương
an biên	kiên giang
cam ranh	khánh hòa
tam nông	phú thọ
quốc oai	hà nội
ninh hòa	khánh hòa
chơn thành	bình phước
bình gia	lạng sơn
xuân trường	nam định
long phú	sóc trăng
quận 11|11|q11	hồ chí minh
văn bàn	lào cai
hoằng hóa	thanh hóa
tây giang	quảng nam
phú ninh	quảng nam
bình chánh	hồ chí minh
chương mỹ	hà nội
núi thành	quảng nam
văn giang	hưng yên
bình lục	hà nam
tuyên hóa	quảng bình
bình tân	vĩnh long
m'đrắk	đắk lắk
kon rẫy	kon tum
hà tiên	kiên giang
hớn quản	bình phước
cần giờ	hồ chí minh
an phú	an giang
bắc sơn	lạng sơn
kim sơn	ninh bình
si ma cai	lào cai
sơn hà	quảng ngãi
hoài ân	bình định
vân hồ	sơn la
đồ sơn	hải phòng
hoa lư	ninh bình
mỹ tú	sóc trăng
long mỹ	hậu giang
dương kinh	hải phòng
phước long	bạc liêu
phù cát	bình định
kiến xương	thái bình
bắc mê	hà giang
bắc ninh	bắc ninh
gò vấp	hồ chí minh
vĩnh thuận	kiên giang
cầu ngang	trà vinh
quận 1|1|q1	hồ chí minh
bắc tân uyên	bình dương
hạ long	quảng ninh
ninh giang	hải dương
kỳ anh	hà tĩnh
lấp vò	đồng tháp
triệu phong	quảng trị
